c,c,o,o,-,-,-,-,-,-,-,-
b,b,b,b,b,-,-,b,b,b,b,b
b,-,-,-,-,-,-,-,-,b,-,b
b,-,b,-,-,b,b,-,-,b,-,-
-,-,b,-,-,b,b,-,-,b,-,-
b,-,b,-,-,-,-,-,-,b,-,-
b,-,b,-,-,-,-,-,-,-,-,b
b,b,b,b,b,-,-,b,b,b,b,b