-,-,-,-,-,-,-,-,-,-,-,-
-,-,d,-,d,-,-,-,-,-,-,-
-,-,s,-,s,-,-,s,s,s,s,-
-,-,s,-,s,-,-,s,-,-,s,-
-,-,s,-,s,-,-,s,-,-,s,-
-,-,s,-,s,-,-,s,s,s,s,-
-,-,-,-,-,-,-,-,-,-,-,-