-,-,-,-,-,-,-,-,-,-,-,-
-,-,-,-,-,-,-,-,-,-,-,-
-,-,-,s,d,d,d,s,-,-,d,-
-,-,-,-,-,-,-,-,-,-,s,-
-,-,-,-,-,-,-,-,-,-,s,-
-,-,-,s,d,d,d,s,d,d,-,-
-,-,-,-,-,-,-,-,-,-,-,-